#tilemap file
width: 32
height: 32
start: 10,10
end: 30,30
map_begin
11111111111111111111111111111111
11000000110000000000000000000111
11000000110111111111111110000111
11000000110111111111111110000111
11110111110111111111111110000111
11110111110111111111111110111111
11000000000111000000011110111111
11011111110111000000000000001111
11011111110111000000011111101111
11011111100011011111111111101111
11011000000011011000111111101111
11011011100011011000111111101111
11011011111111011000111111101111
11011011111111011101111111101111
11011000000000011101111111101111
11011111111111111101111111101111
11000000000000000001111111101111
11110111111111111111111111101111
11110111000000000000000000001111
11110111011111111111111111111111
11110111011111111111111111111111
11110111011110000011111111111111
11110111011110000011111111111111
11110111000000000000000000000011
11110111111110000011111111111011
11110111111111111111111111111011
11110111000001111111111111111011
11110111111101111111111111111011
11000000111000011111111111000001
11000000111000011111111111000001
11000000111000000000000000000001
11111111111111111111111111111111
map_end